0,White,hit
1,BG_Wood_yellow,no
2,BG_Wood_Brown,hit
3,BG_Wood_Ceiling,hit
S,BG_Wood_yellow,start
-1
33333333333333033333
32222222222223032223
32222222222223332223
31111111111112221113
31S11111111112221113
31111111111111111113
31111111111113331113
33331133333333033333
32221123000000000000
32221123333333333333
31111113222222222223
31111113222222222223
31111112111111111113
31111112111111111113
31111111111111111113
-1





q
